diff --git a/src/application/l10n/messages_no.properties b/src/application/l10n/messages_no.properties
index a9524df..3d9bd83 100644
--- a/src/application/l10n/messages_no.properties
+++ b/src/application/l10n/messages_no.properties
@@ -12,6 +12,7 @@ button-select=Velg
 button-add=Legg til
 button-cancel=Avbryt
 button-emboss=Skriv ut
+button-delete=Slette
 emboss-window-title=Skriv ut
 error-cannot-emboss-invalid-file=Kan ikke skrive ut, filen inneholder feil
 error-failed-to-parse-page-range=Klarte ikke å tolke sidespenn: {0}
@@ -31,11 +32,13 @@ checkbox-watch-source=Overv
 title-set-search-folder=Velg søkemappe
 title-open-dialog=Åpne fil
 title-import-braille-text-dialog=Importer punktskriftformatert tekstfil
+title-import-braille-merge-dialog=Merge PEF-files
 title-import-braille-options-dialog=Alternativer
 title-import-source-document-dialog=Importer kildedokument
 title-export-dialog=Eksporter
 title-save-as-dialog=Lagre som...
 title-templates-dialog=Velg mal ({0})
+title-save-template-dialog=Lagre mal
 label-braille-font=Punktskriftfont
 label-text-font=Tekstfont
 label-target-locale=Målsted
@@ -85,18 +88,23 @@ label-source=Kilde
 label-result=Result
 label-word-wrap=Tekstbryting
 label-line-numbers=Linjenummer
+label-target-format=Målformat
+label-make=Make
+label-empty=Tom
 message-six-dot-only=Bare 6-punkt
+label-merge-order=Merge order
 message-search-result={0} av {1}
 message-unknown-author=ukjent
 message-unknown-title=ingen tittel
 message-paper-details={0} - {1} ({2}: {3})
 message-book-dimensions={0} celler bred x {1} celler høy
 message-file-sent-to-embosser=Filen har blitt sendt til punktskriftskriveren
-message-confirm-delete-paper=Er du sikker på at du vil slette {0}?
+message-confirm-delete=Er du sikker på at du vil slette {0}?
 message-file-modified-by-another-application=Filen har blitt endret av et annet program. Vil du laste den inn på nytt og miste endringene du har gjort her?
 message-confirm-save-malformed-xml=Innholdet er ikke velformet XML. Vil du lagre alikevel?
 message-confirm-quit-unsaved-changes=Noen filer har blitt endret men ikke lagret. Vil du avslutte alikevel?
 message-confirm-close-unsaved-changes={0} har blitt endret. Vil du lukke fanen alikevel?
+message-other-metadata-from-first-file=Other meta data is collected from the first file.
 menu-item-preferences=Innstillinger
 menu-item-file=Fil
 menu-item-edit=Rediger
@@ -112,7 +120,8 @@ menu-item-save-as=Lagre som...
 menu-item-import=Importer
 menu-item-import-document=Kildedokument...
 menu-item-import-braille-document=Punktskriftformatert tekstfil...
-menu-item-export=Eksporter...
+menu-item-merge-pef-files=Merge PEF-files...
+menu-item-export=Eksporter
 menu-item-emboss=Skriv ut...
 menu-item-close=Lukk
 menu-item-quit=Avslutt
@@ -123,6 +132,11 @@ menu-item-toggle-viewing-mode=Toggle viewing mode
 menu-item-activate-view=Activate view
 menu-item-next-editor=Neste redigeringsprogram
 menu-item-previous-editor=Forrige redigeringsprogram
+menu-item-show-converter=Vis
+menu-item-apply-template=Bruk mal...
+menu-item-save-template=Lagre mal...
+menu-item-converter=Converter
+menu-item-update=Oppdater
 preferences-window-title=Innstillinger
 tab-emboss=Skriv ut
 tab-general=Generelt
@@ -136,9 +150,11 @@ tooltip-volume-support=St
 tooltip-no-volume-support=Støtter ikke hefter
 tooltip-accurate-line-spacing=Supports accurate line spacing 
 tooltip-simple-line-spacing=Supports simple line spacing only
-tooltip-show-options=Vis alternativer
-tooltip-hide-options=Skjul alternativer
+tooltip-show-converter=Show converter
+tooltip-hide-converter=Hide converter
 tooltip-correct-formatting=Rett formatering
+tooltip-move-up=Move the selected file up (Alt + Up)
+tooltip-move-down=Move the selected file down (Alt + Down)
 value-use-default=[bruk standard]
 extension-filter-supported-files=Filer som støttes
 extension-filter-all-files=Alle filer
